1,2,2,2,2,2,2,2,2,2,2,2,2,7,7,2,2,2,2,2,2,2,2,2,2,2,2,1,
2,5,5,5,5,5,5,5,5,5,5,5,5,4,4,5,5,5,5,5,5,5,5,5,5,5,5,2,
2,5,3,4,4,3,5,3,4,4,4,3,5,4,4,5,3,4,4,4,3,5,3,4,4,3,5,2,
2,6,4,0,0,4,5,4,0,0,0,4,5,4,4,5,4,0,0,0,4,5,4,0,0,4,6,2,
2,5,3,4,4,3,5,3,4,4,4,3,5,3,3,5,3,4,4,4,3,5,3,4,4,3,5,2,
2,5,5,5,5,5,5,5,5,5,5,5,5,5,5,5,5,5,5,5,5,5,5,5,5,5,5,2,
2,5,3,4,4,3,5,3,3,5,3,4,4,4,4,4,4,3,5,3,3,5,3,4,4,3,5,2,
2,5,3,4,4,3,5,4,4,5,3,4,4,3,3,4,4,3,5,4,4,5,3,4,4,3,5,2,
2,5,5,5,5,5,5,4,4,5,5,5,5,4,4,5,5,5,5,4,4,5,5,5,5,5,5,2,
1,2,2,2,2,1,5,4,3,4,4,3,0,4,4,0,3,4,4,3,4,5,1,2,2,2,2,1,
0,0,0,0,0,2,5,4,3,4,4,3,0,3,3,0,3,4,4,3,4,5,2,0,0,0,0,0,
0,0,0,0,0,2,5,4,4,0,0,0,0,0,0,0,0,0,0,4,4,5,2,0,0,0,0,0,
0,0,0,0,0,2,5,4,4,0,3,4,4,0,0,4,4,3,0,4,4,5,2,0,0,0,0,0,
2,2,2,2,2,1,5,3,3,0,4,0,0,0,0,0,0,4,0,3,3,5,1,2,2,2,2,2,
2,2,2,2,2,1,5,3,3,0,4,0,0,0,0,0,0,4,0,3,3,5,1,2,2,2,2,2,
0,0,0,0,0,2,5,4,4,0,3,4,4,0,0,4,4,3,0,4,4,5,2,0,0,0,0,0,
0,0,0,0,0,2,5,4,4,0,0,0,0,0,0,0,0,0,0,4,4,5,2,0,0,0,0,0,
0,0,0,0,0,2,5,4,3,4,4,3,0,3,3,0,3,4,4,3,4,5,2,0,0,0,0,0,
1,2,2,2,2,1,5,4,3,4,4,3,0,4,4,0,3,4,4,3,4,5,1,2,2,2,2,1,
2,5,5,5,5,5,5,4,4,5,5,5,5,4,4,5,5,5,5,4,4,5,5,5,5,5,5,2,
2,5,3,4,4,3,5,4,4,5,3,4,4,3,3,4,4,3,5,4,4,5,3,4,4,3,5,2,
2,5,3,4,4,3,5,3,3,5,3,4,4,4,4,4,4,3,5,3,3,5,3,4,4,3,5,2,
2,5,5,5,5,5,5,5,5,5,5,5,5,5,5,5,5,5,5,5,5,5,5,5,5,5,5,2,
2,5,3,4,4,3,5,3,4,4,4,3,5,3,3,5,3,4,4,4,3,5,3,4,4,3,5,2,
2,6,4,0,0,4,5,4,0,0,0,4,5,4,4,5,4,0,0,0,4,5,4,0,0,4,6,2,
2,5,3,4,4,3,5,3,4,4,4,3,5,4,4,5,3,4,4,4,3,5,3,4,4,3,5,2,
2,5,5,5,5,5,5,5,5,5,5,5,5,4,4,5,5,5,5,5,5,5,5,5,5,5,5,2,
1,2,2,2,2,2,2,2,2,2,2,2,2,7,7,2,2,2,2,2,2,2,2,2,2,2,2,1,
